1,-,-,-,-,-,-,-,-,-,2%
|,x,.,.,.,.,.,.,.,.,|%
|,.,b,.,[,7,],.,b,.,|%
|,.,.,.,.,_,.,.,.,.,|%
|,.,[,],.,p,.,[,],.,|%
|,.,.,.,.,^,.,.,.,.,|%
|,.,b,.,[,+,],.,b,.,|%
|,.,.,.,.,_,.,.,.,.,|%
|,.,[,],.,.,.,[,],.,|%
|,.,.,.,.,^,.,.,.,.,|%
|,.,b,.,[,5,],.,b,.,|%
|,.,.,.,.,.,.,.,.,x,|%
4,-,-,-,-,-,-,-,-,-,3%